#	#	#	#	#	#	#	#	#	#
#	.	#	.	.	.	.	.	@	#
#	.	.	.	.	.	.	#	#	#
#	#	.	.	.	#	#	.	.	#
#	.	.	.	.	.	.	.	.	#
#	.	B	#	#	.	.	.	#	#
#	.	.	.	.	.	.	.	.	#
#	/	.	.	.	#	#	.	.	#
#	.	.	.	.	.	.	.	.	B
#	B	#	#	.	.	.	.	.	#
#	.	.	.	.	.	#	#	.	#
#	.	.	.	.	.	.	.	.	#
#	#	#	#	#	#	#	#	#	#